....................................................................................................
.........................................................................#########..................
.........................................................................##########.................
.........................................................................##.......##................
.........................................................................##........##...............
.........................................................................##.........##..............
........................................#########################........##..#####...##.............
........................................#..........##.###########........##..#####....##............
........................................#.......#..##........##############............##...........
........................................#.......##.######....#####.................##...##..........
........................................#.......##.#######...#####............!!!..##....##.........
........................................#....#..##............................!!!..##.....##........
........................................#....##.######........................!!!..##....##.........
........................................#....##.#######............................##...##..........
........................................#.#..##.................###########............##...........
....########################............#.##.######.............#........##..#####....##............
....#......................#............#.##.#######............#........##..#####...##.............
....#......................#............#.##....................#........##.........##..............
....#......##########......#............#.#####.................#........##........##...............
....#......##########......#............#.#######...............#........##.......##................
....#......##......##......#............#..................###..#........##########.................
....#......##......##......#............#############.....#######........#########..................
....#......##......##......#........................##....###.......................................
....#......##......##......#........................###.....#.......................................
....#......................#........................####....#.......................................
....#......................#........................####....#.......................................
....#......................#........................####....#.......................................
....#......................#........................####....#.......................................
....##########.....#########........................####....#.......................................
............###....#..............#############.....####....#.......................................
....................................................................................................
....................................................................................................
....................................................................................................
....................................................................................................
....................................................................................................
....................................................................................................
....................................................................................................
....................................................................................................
....................................................................................................
